========== DUNGEON MAP ==========

--- Round 0 (Start) ---
+--------------------+
|....................|
|.W..................|
|..Z.................|
|.R..................|
|....................|
|....................|
|....................|
|....................|
|..................M.|
|....................|
+--------------------+

--- Round 1 ---
+--------------------+
|....................|
|....................|
|..W.................|
|...Z................|
|..R.................|
|....................|
|....................|
|.................M..|
|....................|
|....................|
+--------------------+

--- Round 2 ---
+--------------------+
|....................|
|....................|
|....................|
|...W................|
|....Z...............|
|...R................|
|................M...|
|....................|
|....................|
|....................|
+--------------------+

--- Round 3 ---
+--------------------+
|....................|
|....................|
|....................|
|....................|
|....W...............|
|.....Z.........M....|
|....R...............|
|....................|
|....................|
|....................|
+--------------------+

--- Round 4 ---
+--------------------+
|....................|
|....................|
|....................|
|....................|
|....................|
|.....RZ.......M.....|
|....................|
|....................|
|....................|
|....................|
+--------------------+

--- Round 5 ---
+--------------------+
|....................|
|....................|
|....................|
|....................|
|....................|
|......RZ.....M......|
|....................|
|....................|
|....................|
|....................|
+--------------------+

--- Round 6 ---
+--------------------+
|....................|
|....................|
|....................|
|....................|
|....................|
|.......RZ...M.......|
|....................|
|....................|
|....................|
|....................|
+--------------------+

--- Round 7 ---
+--------------------+
|....................|
|....................|
|....................|
|....................|
|....................|
|.......RWZ..M.......|
|....................|
|....................|
|....................|
|....................|
+--------------------+

--- Round 8 ---
+--------------------+
|....................|
|....................|
|....................|
|....................|
|....................|
|.......RWZ..M.......|
|....................|
|....................|
|....................|
|....................|
+--------------------+

--- Round 9 ---
+--------------------+
|....................|
|....................|
|....................|
|....................|
|....................|
|.......RWZ..M.......|
|....................|
|....................|
|....................|
|....................|
+--------------------+

--- Round 10 ---
+--------------------+
|....................|
|....................|
|....................|
|....................|
|....................|
|.......R.Z..M.......|
|....................|
|....................|
|....................|
|....................|
+--------------------+

--- Round 11 ---
+--------------------+
|....................|
|....................|
|....................|
|....................|
|....................|
|.......R.Z..M.......|
|....................|
|....................|
|....................|
|....................|
+--------------------+

--- Round 12 ---
+--------------------+
|....................|
|....................|
|....................|
|....................|
|....................|
|.......R.Z..M.......|
|....................|
|....................|
|....................|
|....................|
+--------------------+

--- Round 13 ---
+--------------------+
|....................|
|....................|
|....................|
|....................|
|....................|
|.......R....M.......|
|....................|
|....................|
|....................|
|....................|
+--------------------+

--- Round 14 ---
+--------------------+
|....................|
|....................|
|....................|
|....................|
|....................|
|.......R............|
|....................|
|....................|
|....................|
|....................|
+--------------------+

